0,0,0,0,0,0,0,0,0,0,0,0,0,0,0,0,0,0,0,0,0,0,0,0,0,0,0,0,0,0,0,0,0,0,0,0,0,0,0,0,0,0,0,0,0,0,0,0,0,0,0,0,0,0,0,0,0,0,0,0,0,0,0,0,0,0,0,0,0,0,0,0,0,0,0,0,0,0,0,0,0,0,0,0,0,0,0,0,0,0,
0,0,0,0,0,0,0,0,0,17,0,0,0,0,0,0,0,0,0,0,0,0,0,0,0,0,0,0,0,0,0,0,0,0,0,0,0,0,0,0,0,0,0,0,0,0,0,0,0,0,0,0,0,0,0,0,0,0,0,0,0,0,0,0,0,0,0,0,0,0,0,0,0,0,0,0,0,0,0,0,0,0,0,0,0,0,0,0,0,0,
0,0,0,0,0,0,0,0,0,0,0,0,0,0,0,0,0,0,0,0,0,0,0,0,0,0,0,0,0,0,0,0,0,0,0,0,0,0,0,0,0,0,0,0,0,0,0,0,0,0,0,0,0,0,0,0,0,0,0,0,0,0,0,0,0,0,0,0,0,0,0,0,0,0,0,0,0,0,0,0,0,0,0,0,0,0,0,0,0,0,
2,2,2,2,2,3,0,0,0,0,0,0,0,0,0,0,0,0,0,0,0,0,0,1,2,2,3,0,0,0,0,0,0,0,0,0,0,0,0,0,0,0,0,0,0,0,0,0,0,0,0,0,0,0,0,0,0,0,0,0,0,0,0,0,0,0,0,0,0,0,0,0,0,0,0,0,0,0,0,0,0,0,0,0,0,0,0,0,0,0,
8,8,8,8,8,9,0,0,0,0,0,0,0,0,0,0,0,0,0,0,0,0,0,7,8,8,9,0,0,0,0,0,0,0,0,0,0,0,0,0,0,0,0,0,0,0,0,0,0,0,0,0,0,0,0,0,0,0,0,0,0,0,0,0,0,0,0,0,0,0,0,0,0,0,0,0,0,0,0,0,0,0,0,0,0,0,0,0,0,0,
0,0,0,0,0,0,0,0,0,0,1,2,2,2,2,3,0,0,1,2,2,3,0,0,0,0,0,0,0,0,0,0,0,0,0,0,0,0,0,0,0,1,2,2,3,0,0,0,0,0,0,0,1,2,3,0,0,0,0,0,0,0,0,0,0,0,0,0,1,2,3,0,0,0,0,1,2,2,2,3,0,0,0,0,0,0,0,0,0,0,
0,0,0,0,0,0,0,0,0,0,7,8,11,5,10,9,0,0,7,8,8,9,0,0,0,0,0,0,0,0,1,2,3,0,0,0,0,0,0,0,0,7,11,5,15,2,2,3,0,0,0,0,7,8,9,0,0,0,0,1,2,2,3,0,0,0,0,0,7,8,9,0,0,0,0,7,8,8,8,9,0,0,0,0,0,0,0,0,0,0,
0,0,0,0,1,2,2,2,3,0,0,0,7,8,9,0,0,0,0,0,0,0,0,0,0,0,0,0,0,1,16,5,15,3,0,0,0,0,0,0,0,0,7,8,8,8,8,9,0,0,0,0,0,0,0,0,0,0,1,16,5,5,15,3,0,0,0,0,0,0,0,0,0,0,0,0,0,0,0,0,0,0,0,0,1,2,2,2,2,2,
0,0,0,0,7,8,8,11,6,0,0,0,0,0,0,0,0,0,0,0,0,0,0,1,2,2,2,2,2,16,5,5,19,15,2,2,2,2,2,3,0,0,0,0,0,0,0,0,0,0,0,0,0,0,0,0,0,1,16,19,19,5,5,15,3,0,0,0,0,0,0,0,0,0,0,0,0,0,0,0,0,0,0,0,7,8,8,8,8,8,
0,0,0,0,0,0,0,7,9,0,0,0,0,0,0,1,2,2,3,0,0,0,0,4,5,5,5,5,5,5,5,5,5,5,5,18,18,5,5,6,0,0,0,0,0,0,0,0,0,1,2,2,2,2,2,2,2,16,5,5,19,5,18,5,15,2,2,2,2,2,2,2,2,2,2,2,3,0,0,0,0,0,0,0,0,0,0,0,0,0,
2,2,3,0,0,0,0,0,0,0,0,0,0,0,1,16,10,8,13,2,2,3,0,7,8,8,8,8,8,8,8,8,8,8,8,8,8,8,8,9,0,0,0,0,0,0,0,0,1,16,19,19,5,19,5,19,19,19,19,5,5,5,19,19,5,5,5,19,5,5,5,5,5,5,5,5,6,0,0,0,0,0,0,0,0,0,0,0,0,0,
5,18,6,0,0,0,0,0,0,0,0,0,0,1,16,10,9,0,7,8,8,9,0,0,0,0,0,0,0,0,0,0,0,0,0,0,0,0,0,0,0,0,0,0,0,0,1,2,16,5,18,18,5,5,5,5,5,5,5,5,18,5,5,5,5,5,5,5,5,10,8,8,8,8,8,8,9,0,0,0,0,1,2,2,2,3,0,0,0,0,
5,5,15,3,0,0,0,0,1,2,2,2,2,16,10,9,0,0,0,0,0,0,0,0,0,0,0,0,0,0,0,0,0,0,0,0,0,0,0,0,0,0,0,0,0,0,7,8,8,8,8,8,8,8,8,8,8,8,8,8,8,8,8,8,8,8,8,8,8,9,0,0,0,0,0,0,0,0,0,0,0,7,8,8,8,9,0,0,0,0,
8,8,11,15,3,0,0,0,7,11,5,5,5,10,9,0,0,0,0,0,0,0,0,0,0,0,0,0,0,0,0,0,0,0,0,0,0,0,0,0,0,0,0,0,0,0,0,0,0,0,0,0,0,0,0,0,0,0,0,0,0,0,0,0,0,0,0,0,0,0,0,0,0,0,0,0,0,0,0,0,0,0,0,0,0,0,0,0,0,0,
0,0,4,5,15,2,3,0,0,7,8,8,8,9,0,0,0,1,2,2,2,2,2,2,2,2,2,2,2,2,2,2,2,2,2,2,2,2,2,2,2,2,2,2,2,3,0,0,0,0,0,0,0,0,0,0,0,0,0,0,0,0,0,0,0,0,0,0,0,0,0,0,0,0,0,0,0,0,0,0,0,0,0,0,0,0,0,0,0,0,
0,0,7,8,8,8,9,0,0,0,0,0,0,0,0,0,0,7,8,8,8,8,8,8,8,8,11,5,5,5,10,8,8,8,8,8,8,8,8,8,8,8,8,8,8,9,0,0,0,0,0,0,0,0,0,0,0,0,0,0,0,0,0,0,0,0,0,0,0,0,1,2,2,2,2,2,2,2,2,2,2,2,2,2,2,2,2,2,2,2,
0,0,0,0,0,0,0,0,0,0,0,0,0,0,0,0,0,0,0,0,0,0,0,0,0,0,7,11,18,5,6,0,0,0,0,0,0,0,0,0,0,0,0,0,0,0,0,0,0,0,0,0,0,0,0,0,1,2,2,2,2,2,2,2,2,2,2,2,2,2,16,10,8,8,8,8,8,8,8,8,8,8,8,8,8,8,8,8,8,8,
0,0,0,0,0,0,0,0,1,2,2,2,2,2,2,3,0,0,0,0,0,0,0,0,0,0,0,7,11,18,6,0,0,0,0,0,0,0,0,0,0,0,0,0,0,0,0,0,0,0,0,0,0,0,1,2,12,8,8,8,8,8,8,8,8,8,8,8,8,8,8,9,0,0,0,0,0,0,0,0,0,0,0,0,0,0,0,0,0,0,
0,0,0,0,0,0,0,0,7,8,11,5,5,10,8,9,0,0,0,0,0,0,0,0,0,0,0,0,7,11,15,2,2,2,3,0,0,0,0,0,0,0,0,0,0,0,0,0,0,0,0,0,0,1,16,10,9,0,0,0,0,0,0,0,0,0,0,0,0,0,0,0,0,0,0,0,0,0,0,0,0,0,0,0,0,0,0,0,0,0,
2,2,2,2,2,3,0,0,0,0,7,8,8,9,0,0,0,0,0,0,0,0,0,0,0,0,0,0,0,7,8,8,8,11,15,3,0,0,0,0,0,1,2,2,2,2,2,2,2,2,3,0,0,7,8,9,0,0,0,0,0,0,0,0,0,0,0,0,0,0,0,0,0,0,0,0,0,0,0,0,0,0,0,0,0,0,0,0,0,0,
5,5,5,5,18,6,0,0,0,0,0,0,0,0,0,0,0,1,2,2,2,2,2,2,3,0,0,0,0,0,0,0,0,7,5,15,3,0,0,0,1,16,5,5,19,19,19,5,19,5,15,3,0,0,0,0,0,0,0,1,2,2,3,0,0,0,0,0,0,0,0,0,0,0,0,0,0,0,0,0,0,0,0,0,0,0,0,0,0,0,
8,8,8,8,8,9,0,0,0,0,0,0,0,0,0,0,1,16,10,8,8,8,8,8,9,0,0,0,0,0,0,0,0,0,7,8,9,0,0,0,4,5,19,5,5,5,5,5,5,5,5,6,0,0,0,0,1,2,2,16,5,5,15,2,3,0,0,0,0,0,0,1,2,3,0,0,0,0,0,0,0,1,2,2,3,0,0,0,0,1,
0,0,0,0,0,0,0,0,0,0,0,0,0,0,0,0,7,8,9,0,0,0,0,0,0,0,0,1,2,3,0,0,0,0,0,0,0,0,0,0,7,8,8,8,8,8,8,8,8,8,8,9,0,1,2,2,16,10,8,8,8,8,8,11,15,2,2,2,3,0,0,7,8,9,0,0,0,0,0,0,0,4,5,10,9,0,0,0,1,16,
0,0,0,0,0,0,0,1,2,3,0,0,0,0,0,0,0,0,0,0,0,0,0,0,0,0,1,16,19,15,3,0,0,0,0,0,0,0,0,0,0,0,0,0,0,0,0,0,0,0,0,0,0,4,10,8,8,9,0,0,0,0,0,7,8,8,8,8,9,0,0,0,0,0,0,0,0,0,0,0,0,7,8,9,0,0,0,1,16,18,
0,0,0,0,0,0,0,7,8,9,0,0,0,0,0,0,0,0,0,0,0,0,0,0,0,1,16,19,19,5,6,0,0,1,2,2,2,2,3,0,0,0,0,0,0,0,0,0,0,0,0,0,1,16,6,0,0,0,0,0,0,0,0,0,0,0,0,0,0,0,0,0,0,0,1,2,2,2,2,3,0,0,0,0,0,0,1,16,18,19,
0,0,0,0,0,0,0,0,0,0,0,0,0,1,3,0,0,0,0,0,0,0,0,0,1,16,5,19,10,8,9,0,0,4,5,5,5,18,15,2,3,0,0,0,0,0,0,0,0,0,0,1,16,10,9,0,0,0,0,0,0,0,0,0,0,0,0,0,0,0,1,2,3,0,7,8,8,8,8,9,0,0,0,0,0,1,16,18,18,19,
0,0,0,1,2,2,3,0,0,0,0,1,2,16,15,2,3,0,0,0,0,1,2,2,16,5,18,10,9,0,0,0,0,7,8,8,8,8,8,8,9,0,0,0,0,0,0,0,0,0,1,16,10,9,0,0,0,0,1,2,2,3,0,0,0,0,0,0,0,1,16,10,9,0,0,0,0,0,0,0,0,0,0,0,1,16,18,18,19,19,
0,0,0,7,8,8,9,0,0,0,0,7,8,8,8,8,9,0,0,0,1,16,19,5,10,8,8,9,0,0,0,0,0,0,0,0,0,0,0,0,0,0,0,1,2,3,0,0,0,0,7,8,9,0,0,0,0,0,7,8,8,9,0,0,0,0,0,0,0,7,8,9,0,0,0,0,0,0,0,0,0,0,0,1,16,18,18,19,19,5,
0,0,0,0,0,0,0,0,0,0,0,0,0,0,0,0,0,0,0,1,16,19,5,5,6,0,0,0,0,0,0,0,0,0,0,0,0,0,0,0,0,0,1,16,18,15,3,0,0,0,0,0,0,0,0,0,0,0,0,0,0,0,0,0,0,0,0,0,0,0,0,0,0,0,0,0,0,0,0,0,0,0,1,16,18,18,19,19,18,19,
2,2,3,0,0,0,0,1,2,3,0,0,0,0,0,0,0,0,1,16,19,19,5,18,6,0,0,0,0,0,0,0,0,0,0,0,0,0,0,0,1,2,16,18,5,5,15,2,3,0,0,0,0,0,0,0,0,0,0,0,0,0,0,0,0,0,0,0,0,0,0,0,0,0,0,0,0,0,0,0,0,1,16,18,18,19,19,18,18,5,
5,5,15,2,2,2,2,16,5,15,2,2,2,2,2,2,2,2,16,5,19,5,5,18,15,2,2,2,2,2,2,2,2,2,2,2,2,2,2,2,16,18,18,5,5,5,5,5,15,2,2,2,2,2,2,2,2,2,2,2,2,2,2,2,2,2,2,2,2,2,2,2,2,2,2,2,2,2,2,2,2,16,18,18,19,19,5,19,5,5,
5,5,5,5,5,5,5,5,5,5,5,5,5,5,5,5,5,5,5,5,5,5,5,5,5,5,5,5,5,5,5,5,5,5,5,5,5,5,5,5,5,5,5,5,5,5,5,5,5,5,5,5,5,5,5,5,5,5,5,5,5,5,5,5,5,5,5,5,5,5,5,5,5,5,5,5,5,5,5,5,5,5,5,5,5,5,5,5,5,5,

