5,5,5,5,5,5,5,5,5,5,5,5,5,5,5,5,5,5,5,5,5,5,5,5,5,5,5,5,5,5,5,5,5,5,5,5,5,5,5,5,5,5,5,5,5,5,5,5,5,5,5,5,5,5,5,5,5,5,5,5,5,5,5,5,5,5,5,5,5,5,5,5,5,5,5,5,5,5,5,5,5,5,5,5,5,5,5,5,5,5,5,5,5,5,5,5,5,5,5,5,5,5,5,5,5,5,5,5,5,5,5,5,5,5,5,5,5,5,5,5,5,5,5,5,5,5,5,5,5,5,5,5,5,5,5,5,
5,10,8,8,8,8,8,8,8,8,8,8,8,8,8,8,8,8,8,8,8,8,8,8,8,8,8,8,8,8,8,8,8,8,8,8,8,8,8,8,8,8,8,8,8,8,8,8,8,8,8,8,8,8,8,8,8,8,8,8,8,8,8,8,8,8,8,8,8,8,8,8,8,8,8,8,8,8,8,8,8,8,8,8,8,8,8,8,8,8,8,8,8,8,8,8,8,8,8,8,8,8,8,8,8,8,8,8,8,8,8,8,8,8,8,8,8,8,8,8,8,8,8,8,8,8,8,8,8,8,8,8,8,8,11,5,
5,6,0,0,0,0,0,0,0,0,0,0,0,0,0,0,0,0,0,0,0,0,0,0,0,0,0,0,0,0,0,0,0,0,0,0,0,0,0,0,0,0,0,0,0,0,0,0,0,0,0,0,0,0,0,0,0,0,0,0,0,0,0,0,0,0,0,0,0,0,0,0,0,0,0,0,0,0,0,0,0,0,0,0,0,0,0,0,0,0,0,0,0,0,0,0,0,0,0,0,0,0,0,0,0,0,0,0,0,0,0,0,0,0,0,0,0,0,0,0,0,0,0,0,0,0,0,0,0,0,0,0,0,0,4,5,
5,6,0,0,0,0,0,0,0,0,0,0,0,0,0,0,0,0,0,0,0,0,0,0,0,0,0,0,0,0,0,0,0,0,0,0,0,0,0,0,0,0,0,0,0,0,0,0,0,0,0,0,0,0,0,0,0,0,0,0,0,0,0,0,0,0,0,0,0,0,0,0,0,0,0,0,0,0,0,0,0,0,0,0,0,0,0,0,0,0,0,0,0,0,0,0,0,0,0,0,0,0,0,0,0,0,0,0,0,0,0,0,0,0,0,0,0,0,0,0,0,0,0,0,0,0,0,0,0,0,0,0,0,0,4,5,
5,6,0,0,0,0,0,0,0,0,0,0,0,0,0,0,0,0,0,0,0,0,0,0,0,0,0,0,0,0,0,0,0,0,1,2,2,3,0,0,0,0,0,0,0,0,0,0,0,0,0,0,0,0,0,0,0,0,1,2,2,3,0,0,0,0,0,0,0,0,0,0,0,0,0,0,0,0,0,0,0,0,0,0,0,0,0,0,0,0,0,0,0,0,0,0,0,0,0,0,0,0,0,0,0,0,0,0,0,0,0,0,0,0,1,2,2,3,0,0,0,0,0,0,0,0,0,0,0,0,0,0,0,0,4,5,
5,6,0,0,0,0,0,0,0,0,0,0,0,0,1,2,2,3,0,0,0,0,0,0,0,0,0,0,0,0,1,2,2,2,16,5,5,15,2,2,2,3,0,0,0,0,0,0,0,0,0,0,0,0,1,2,2,2,16,5,5,15,2,2,2,3,0,0,0,0,0,0,0,0,0,0,0,0,1,2,2,3,0,0,0,0,0,0,0,0,0,0,0,0,1,2,2,3,0,0,0,0,0,0,0,0,0,0,0,0,1,2,2,2,16,5,5,15,2,2,2,3,0,0,0,0,0,0,0,0,0,0,0,0,4,5,
5,15,2,2,2,3,0,0,0,0,1,2,2,2,16,5,5,6,0,0,0,0,0,0,0,0,1,2,2,2,16,5,5,10,8,8,8,8,11,5,5,15,2,2,2,3,0,0,0,0,0,0,0,0,4,5,5,10,8,8,8,8,11,5,5,15,2,2,2,3,0,0,0,0,1,2,2,2,16,5,5,15,2,2,2,3,0,0,0,0,1,2,2,2,16,5,5,15,2,2,2,3,0,0,0,0,0,0,0,0,4,5,5,10,8,8,8,8,11,5,5,15,2,2,2,3,0,0,0,0,1,2,2,2,16,5,
5,5,5,5,5,15,2,2,2,2,16,5,5,10,8,8,8,9,0,0,0,0,1,2,2,2,16,5,5,10,8,8,8,9,0,0,0,0,7,8,8,8,11,5,5,15,2,2,2,3,0,0,0,0,7,8,8,9,0,0,0,0,7,8,8,8,11,5,5,15,2,2,2,2,16,5,5,10,8,8,8,8,11,5,5,15,2,2,2,2,16,5,5,10,8,8,8,8,11,5,5,15,2,2,3,0,0,0,0,0,7,8,8,9,0,0,0,0,7,8,8,8,11,5,5,15,2,2,2,2,16,5,5,5,5,5,
5,10,8,8,8,8,11,5,5,10,8,8,8,9,0,0,0,0,0,0,0,0,4,5,5,10,8,8,8,9,0,0,0,0,0,0,0,0,0,0,0,0,7,8,8,8,11,5,5,6,0,0,0,0,0,0,0,0,0,0,0,0,0,0,0,0,7,8,8,8,11,5,5,10,8,8,8,9,0,0,0,0,7,8,8,8,11,5,5,10,8,8,8,9,0,0,0,0,7,8,8,11,5,5,6,0,0,0,0,0,0,0,0,0,0,0,0,0,0,0,0,0,7,8,8,8,11,5,5,10,8,8,8,8,11,5,
5,6,0,0,0,0,7,8,8,9,0,0,0,0,0,0,0,0,0,0,0,0,7,8,8,9,0,0,0,0,0,0,0,0,0,0,0,0,0,0,0,0,0,0,0,0,7,8,8,9,0,0,0,0,0,0,0,0,0,0,0,0,0,0,0,0,0,0,0,0,7,8,8,9,0,0,0,0,0,0,0,0,0,0,0,0,7,8,8,9,0,0,0,0,0,0,0,0,0,0,0,7,8,8,9,0,0,0,0,0,0,0,0,0,0,0,0,0,0,0,0,0,0,0,0,0,7,8,8,9,0,0,0,0,4,5,
5,6,0,0,0,0,0,0,0,0,0,0,0,0,0,0,0,0,0,0,0,0,0,0,0,0,0,0,0,0,0,0,0,0,0,0,0,0,0,0,0,0,0,0,0,0,0,0,0,0,0,0,0,0,0,0,0,0,0,0,0,0,0,0,0,0,0,0,0,0,0,0,0,0,0,0,0,0,0,0,0,0,0,0,0,0,0,0,0,0,0,0,0,0,0,0,0,0,0,0,0,0,0,0,0,0,0,0,0,0,0,0,0,0,0,0,0,0,0,0,0,0,0,0,0,0,0,0,0,0,0,0,0,0,4,5,
5,6,0,0,0,0,0,0,0,0,0,0,0,0,0,0,0,0,0,0,0,0,0,0,0,0,0,0,0,0,0,0,0,0,1,2,2,3,0,0,0,0,0,0,0,0,0,0,0,0,0,0,0,0,0,0,0,0,1,2,2,3,0,0,0,0,0,0,0,0,0,0,0,0,0,0,0,0,0,0,0,0,0,0,0,0,0,0,0,0,0,0,0,0,0,0,0,0,0,0,0,0,0,0,0,0,0,0,0,0,0,0,0,0,1,2,2,3,0,0,0,0,0,0,0,0,0,0,0,0,0,0,0,0,4,5,
5,6,0,0,0,0,0,0,0,0,0,0,0,0,1,2,2,3,0,0,0,0,0,0,0,0,0,0,0,0,1,2,2,2,16,5,5,15,2,2,2,3,0,0,0,0,0,0,0,0,0,0,0,0,1,2,2,2,16,5,5,15,2,2,2,3,0,0,0,0,0,0,0,0,0,0,0,0,1,2,2,3,0,0,0,0,0,0,0,0,0,0,0,0,1,2,2,3,0,0,0,0,0,0,0,0,0,0,0,0,1,2,2,2,16,5,5,15,2,2,2,3,0,0,0,0,0,0,0,0,0,0,0,0,4,5,
5,15,2,2,2,3,0,0,0,0,1,2,2,2,16,5,5,6,0,0,0,0,0,0,0,0,1,2,2,2,16,5,5,10,8,8,8,8,11,5,5,15,2,2,2,3,0,0,0,0,0,0,0,0,4,5,5,10,8,8,8,8,11,5,5,15,2,2,2,3,0,0,0,0,1,2,2,2,16,5,5,15,2,2,2,3,0,0,0,0,1,2,2,2,16,5,5,15,2,2,2,3,0,0,0,0,0,0,0,0,4,5,5,10,8,8,8,8,11,5,5,15,2,2,2,3,0,0,0,0,1,2,2,2,16,5,
5,5,5,5,5,15,2,2,2,2,16,5,5,10,8,8,8,9,0,0,0,0,1,2,2,2,16,5,5,10,8,8,8,9,0,0,0,0,7,8,8,8,11,5,5,15,2,2,2,3,0,0,0,0,7,8,8,9,0,0,0,0,7,8,8,8,11,5,5,15,2,2,2,2,16,5,5,10,8,8,8,8,11,5,5,15,2,2,2,2,16,5,5,10,8,8,8,8,11,5,5,15,2,2,3,0,0,0,0,0,7,8,8,9,0,0,0,0,7,8,8,8,11,5,5,15,2,2,2,2,16,5,5,5,5,5,
5,10,8,8,8,8,11,5,5,5,8,8,8,9,0,0,0,0,0,0,0,0,4,5,5,10,8,8,8,9,0,0,0,0,0,0,0,0,0,0,0,0,7,8,8,8,11,5,5,6,0,0,0,0,0,0,0,0,0,0,0,0,0,0,0,0,7,8,8,8,11,5,5,10,8,8,8,9,0,0,0,0,7,8,8,8,11,5,5,10,8,8,8,9,0,0,0,0,7,8,8,11,5,5,6,0,0,0,0,0,0,0,0,0,0,0,0,0,0,0,0,0,7,8,8,8,11,5,5,10,8,8,8,8,11,5,
5,6,0,0,0,0,7,8,8,9,0,0,0,0,0,0,0,0,0,0,0,0,7,8,8,9,0,0,0,0,0,0,0,0,0,0,0,0,0,0,0,0,0,0,0,0,7,8,8,9,0,0,0,0,0,0,0,0,0,0,0,0,0,0,0,0,0,0,0,0,7,8,8,9,0,0,0,0,0,0,0,0,0,0,0,0,7,8,8,9,0,0,0,0,0,0,0,0,0,0,0,7,8,8,9,0,0,0,0,0,0,0,0,0,0,0,0,0,0,0,0,0,0,0,0,0,7,8,8,9,0,0,0,0,4,5,
5,6,0,0,0,0,0,0,0,0,0,0,0,0,0,0,0,0,0,0,0,0,0,0,0,0,0,0,0,0,0,0,0,0,0,0,0,0,0,0,0,0,0,0,0,0,0,0,0,0,0,0,0,0,0,0,0,0,0,0,0,0,0,0,0,0,0,0,0,0,0,0,0,0,0,0,0,0,0,0,0,0,0,0,0,0,0,0,0,0,0,0,0,0,0,0,0,0,0,0,0,0,0,0,0,0,0,0,0,0,0,0,0,0,0,0,0,0,0,0,0,0,0,0,0,0,0,0,0,0,0,0,0,0,4,5,
5,6,0,0,0,0,0,0,0,0,0,0,0,0,0,0,0,0,0,0,0,0,0,0,0,0,0,0,0,0,0,0,0,0,1,2,2,3,0,0,0,0,0,0,0,0,0,0,0,0,0,0,0,0,0,0,0,0,1,2,2,3,0,0,0,0,0,0,0,0,0,0,0,0,0,0,0,0,0,0,0,0,0,0,0,0,0,0,0,0,0,0,0,0,0,0,0,0,0,0,0,0,0,0,0,0,0,0,0,0,0,0,0,0,1,2,2,3,0,0,0,0,0,0,0,0,0,0,0,0,0,0,0,0,4,5,
5,6,0,0,0,0,0,0,0,0,0,0,0,0,1,2,2,3,0,0,0,0,0,0,0,0,0,0,0,0,1,2,2,2,16,5,5,15,2,2,2,3,0,0,0,0,0,0,0,0,0,0,0,0,1,2,2,2,16,5,5,15,2,2,2,3,0,0,0,0,0,0,0,0,0,0,0,0,1,2,2,3,0,0,0,0,0,0,0,0,0,0,0,0,1,2,2,3,0,0,0,0,0,0,0,0,0,0,0,0,1,2,2,2,16,5,5,15,2,2,2,3,0,0,0,0,0,0,0,0,0,0,0,0,4,5,
5,15,2,2,2,3,0,0,0,0,1,2,2,2,16,5,5,6,0,0,0,0,0,0,0,0,1,2,2,2,16,5,5,10,8,8,8,8,11,5,5,15,2,2,2,3,0,0,0,0,0,0,0,0,4,5,5,10,8,8,8,8,11,5,5,15,2,2,2,3,0,0,0,0,1,2,2,2,16,5,5,15,2,2,2,3,0,0,0,0,1,2,2,2,16,5,5,15,2,2,2,3,0,0,0,0,0,0,0,0,4,5,5,10,8,8,8,8,11,5,5,15,2,2,2,3,0,0,0,0,1,2,2,2,16,5,
5,5,5,5,5,15,2,2,2,2,16,5,5,10,8,8,8,9,0,0,0,0,1,2,2,2,16,5,5,10,8,8,8,9,0,0,0,0,7,8,8,8,11,5,5,15,2,2,2,3,0,0,0,0,7,8,8,9,0,0,0,0,7,8,8,8,11,5,5,15,2,2,2,2,16,5,5,10,8,8,8,8,11,5,5,15,2,2,2,2,16,5,5,10,8,8,8,8,11,5,5,15,2,2,3,0,0,0,0,0,7,8,8,9,0,0,0,0,7,8,8,8,11,5,5,15,2,2,2,2,16,5,5,5,5,5,
5,10,8,8,8,8,11,5,5,10,8,8,8,9,0,0,0,0,0,0,0,0,4,5,5,10,8,8,8,9,0,0,0,0,0,0,0,0,0,0,0,0,7,8,8,8,11,5,5,6,0,0,0,0,0,0,0,0,0,0,0,0,0,0,0,0,7,8,8,8,11,5,5,10,8,8,8,9,0,0,0,0,7,8,8,8,11,5,5,10,8,8,8,9,0,0,0,0,7,8,8,11,5,5,6,0,0,0,0,0,0,0,0,0,0,0,0,0,0,0,0,0,7,8,8,8,11,5,5,10,8,8,8,8,11,5,
5,6,0,0,0,0,7,8,8,9,0,0,0,0,0,0,0,0,0,0,0,0,7,8,8,9,0,0,0,0,0,0,0,0,0,0,0,0,0,0,0,0,0,0,0,0,7,8,8,9,0,0,0,0,0,0,0,0,0,0,0,0,0,0,0,0,0,0,0,0,7,8,8,9,0,0,0,0,0,0,0,0,0,0,0,0,7,8,8,9,0,0,0,0,0,0,0,0,0,0,0,7,8,8,9,0,0,0,0,0,0,0,0,0,0,0,0,0,0,0,0,0,0,0,0,0,7,8,8,9,0,0,0,0,4,5,
5,6,0,0,0,0,0,0,0,0,0,0,0,0,0,0,0,0,0,0,0,0,0,0,0,0,0,0,0,0,0,0,0,0,0,0,0,0,0,0,0,0,0,0,0,0,0,0,0,0,0,0,0,0,0,0,0,0,0,0,0,0,0,0,0,0,0,0,0,0,0,0,0,0,0,0,0,0,0,0,0,0,0,0,0,0,0,0,0,0,0,0,0,0,0,0,0,0,0,0,0,0,0,0,0,0,0,0,0,0,0,0,0,0,0,0,0,0,0,0,0,0,0,0,0,0,0,0,0,0,0,0,0,0,4,5,
5,6,0,0,0,0,0,0,0,0,0,0,0,0,0,0,0,0,0,0,0,0,0,0,0,0,0,0,0,0,0,0,0,0,1,2,2,3,0,0,0,0,0,0,0,0,0,0,0,0,0,0,0,0,0,0,0,0,1,2,2,3,0,0,0,0,0,0,0,0,0,0,0,0,0,0,0,0,0,0,0,0,0,0,0,0,0,0,0,0,0,0,0,0,0,0,0,0,0,0,0,0,0,0,0,0,0,0,0,0,0,0,0,0,1,2,2,3,0,0,0,0,0,0,0,0,0,0,0,0,0,0,0,0,4,5,
5,6,0,0,0,0,0,0,0,0,0,0,0,0,1,2,2,3,0,0,0,0,0,0,0,0,0,0,0,0,1,2,2,2,16,5,5,15,2,2,2,3,0,0,0,0,0,0,0,0,0,0,0,0,1,2,2,2,16,5,5,15,2,2,2,3,0,0,0,0,0,0,0,0,0,0,0,0,1,2,2,3,0,0,0,0,0,0,0,0,0,0,0,0,1,2,2,3,0,0,0,0,0,0,0,0,0,0,0,0,1,2,2,2,16,5,5,15,2,2,2,3,0,0,0,0,0,0,0,0,0,0,0,0,4,5,
5,15,2,2,2,3,0,0,0,0,1,2,2,2,16,5,5,6,0,0,0,0,0,0,0,0,1,2,2,2,16,5,5,10,8,8,8,8,11,5,5,15,2,2,2,3,0,0,0,0,0,0,0,0,4,5,5,10,8,8,8,8,11,5,5,15,2,2,2,3,0,0,0,0,1,2,2,2,16,5,5,15,2,2,2,3,0,0,0,0,1,2,2,2,16,5,5,15,2,2,2,3,0,0,0,0,0,0,0,0,4,5,5,10,8,8,8,8,11,5,5,15,2,2,2,3,0,0,0,0,1,2,2,2,16,5,
5,5,5,5,5,15,2,2,2,2,16,5,5,10,8,8,8,9,0,0,0,0,1,2,2,2,16,5,5,10,8,8,8,9,0,0,0,0,7,8,8,8,11,5,5,15,2,2,2,3,0,0,0,0,7,8,8,9,0,0,0,0,7,8,8,8,11,5,5,15,2,2,2,2,16,5,5,10,8,8,8,8,11,5,5,15,2,2,2,2,16,5,5,10,8,8,8,8,11,5,5,15,2,2,3,0,0,0,0,0,7,8,8,9,0,0,0,0,7,8,8,8,11,5,5,15,2,2,2,2,16,5,5,5,5,5,
5,10,8,8,8,8,11,5,5,10,8,8,8,9,0,0,0,0,0,0,0,0,4,5,5,10,8,8,8,9,0,0,0,0,0,0,0,0,0,0,0,0,7,8,8,8,11,5,5,6,0,0,0,0,0,0,0,0,0,0,0,0,0,0,0,0,7,8,8,8,11,5,5,10,8,8,8,9,0,0,0,0,7,8,8,8,11,5,5,10,8,8,8,9,0,0,0,0,7,8,8,11,5,5,6,0,0,0,0,0,0,0,0,0,0,0,0,0,0,0,0,0,7,8,8,8,11,5,5,10,8,8,8,8,11,5,
5,6,0,0,0,0,7,8,8,9,0,0,0,0,0,0,0,0,0,0,0,0,7,8,8,9,0,0,0,0,0,0,0,0,0,0,0,0,0,0,0,0,0,0,0,0,7,8,8,9,0,0,0,0,0,0,0,0,0,0,0,0,0,0,0,0,0,0,0,0,7,8,8,9,0,0,0,0,0,0,0,0,0,0,0,0,7,8,8,9,0,0,0,0,0,0,0,0,0,0,0,7,8,8,9,0,0,0,0,0,0,0,0,0,0,0,0,0,0,0,0,0,0,0,0,0,7,8,8,9,0,0,0,0,4,5,
5,6,0,0,0,0,0,0,0,0,0,0,0,0,0,0,0,0,0,0,0,0,0,0,0,0,0,0,0,0,0,0,0,0,0,0,0,0,0,0,0,0,0,0,0,0,0,0,0,0,0,0,0,0,0,0,0,0,0,0,0,0,0,0,0,0,0,0,0,0,0,0,0,0,0,0,0,0,0,0,0,0,0,0,0,0,0,0,0,0,0,0,0,0,0,0,0,0,0,0,0,0,0,0,0,0,0,0,0,0,0,0,0,0,0,0,0,0,0,0,0,0,0,0,0,0,0,0,0,0,0,0,0,0,4,5,
5,6,0,0,0,0,0,0,0,0,0,0,0,0,0,0,0,0,0,0,0,0,0,0,0,0,0,0,0,0,0,0,0,0,1,2,2,3,0,0,0,0,0,0,0,0,0,0,0,0,0,0,0,0,0,0,0,0,1,2,2,3,0,0,0,0,0,0,0,0,0,0,0,0,0,0,0,0,0,0,0,0,0,0,0,0,0,0,0,0,0,0,0,0,0,0,0,0,0,0,0,0,0,0,0,0,0,0,0,0,0,0,0,0,1,2,2,3,0,0,0,0,0,0,0,0,0,0,0,0,0,0,0,0,4,5,
5,6,0,0,0,0,0,0,0,0,0,0,0,0,1,2,2,3,0,0,0,0,0,0,0,0,0,0,0,0,1,2,2,2,16,5,5,15,2,2,2,3,0,0,0,0,0,0,0,0,0,0,0,0,1,2,2,2,16,5,5,15,2,2,2,3,0,0,0,0,0,0,0,0,0,0,0,0,1,2,2,3,0,0,0,0,0,0,0,0,0,0,0,0,1,2,2,3,0,0,0,0,0,0,0,0,0,0,0,0,1,2,2,2,16,5,5,15,2,2,2,3,0,0,0,0,0,0,0,0,0,0,0,0,4,5,
5,15,2,2,2,3,0,0,0,0,1,2,2,2,16,5,5,6,0,0,0,0,0,0,0,0,1,2,2,2,16,5,5,10,8,8,8,8,11,5,5,15,2,2,2,3,0,0,0,0,0,0,0,0,4,5,5,10,8,8,8,8,11,5,5,15,2,2,2,3,0,0,0,0,1,2,2,2,16,5,5,15,2,2,2,3,0,0,0,0,1,2,2,2,16,5,5,15,2,2,2,3,0,0,0,0,0,0,0,0,4,5,5,10,8,8,8,8,11,5,5,15,2,2,2,3,0,0,0,0,1,2,2,2,16,5,
5,5,5,5,5,15,2,2,2,2,16,5,5,10,8,8,8,9,0,0,0,0,1,2,2,2,16,5,5,10,8,8,8,9,0,0,0,0,7,8,8,8,11,5,5,15,2,2,2,3,0,0,0,0,7,8,8,9,0,0,0,0,7,8,8,8,11,5,5,15,2,2,2,2,16,5,5,10,8,8,8,8,11,5,5,15,2,2,2,2,16,5,5,10,8,8,8,8,11,5,5,15,2,2,3,0,0,0,0,0,7,8,8,9,0,0,0,0,7,8,8,8,11,5,5,15,2,2,2,2,16,5,5,5,5,5,
5,10,8,8,8,8,11,5,5,10,8,8,8,9,0,0,0,0,0,0,0,0,4,5,5,10,8,8,8,9,0,0,0,0,0,0,0,0,0,0,0,0,7,8,8,8,11,5,5,6,0,0,0,0,0,0,0,0,0,0,0,0,0,0,0,0,7,8,8,8,11,5,5,10,8,8,8,9,0,0,0,0,7,8,8,8,11,5,5,10,8,8,8,9,0,0,0,0,7,8,8,11,5,5,6,0,0,0,0,0,0,0,0,0,0,0,0,0,0,0,0,0,7,8,8,8,11,5,5,10,8,8,8,8,11,5,
5,6,0,0,0,0,7,8,8,9,0,0,0,0,0,0,0,0,0,0,0,0,7,8,8,9,0,0,0,0,0,0,0,0,0,0,0,0,0,0,0,0,0,0,0,0,7,8,8,9,0,0,0,0,0,0,0,0,0,0,0,0,0,0,0,0,0,0,0,0,7,8,8,9,0,0,0,0,0,0,0,0,0,0,0,0,7,8,8,9,0,0,0,0,0,0,0,0,0,0,0,7,8,8,9,0,0,0,0,0,0,0,0,0,0,0,0,0,0,0,0,0,0,0,0,0,7,8,8,9,0,0,0,0,4,5,
5,6,0,0,0,0,0,0,0,0,0,0,0,0,0,0,0,0,0,0,0,0,0,0,0,0,0,0,0,0,0,0,0,0,0,0,0,0,0,0,0,0,0,0,0,0,0,0,0,0,0,0,0,0,0,0,0,0,0,0,0,0,0,0,0,0,0,0,0,0,0,0,0,0,0,0,0,0,0,0,0,0,0,0,0,0,0,0,0,0,0,0,0,0,0,0,0,0,0,0,0,0,0,0,0,0,0,0,0,0,0,0,0,0,0,0,0,0,0,0,0,0,0,0,0,0,0,0,0,0,0,0,0,0,4,5,
5,6,0,0,0,0,0,0,0,0,0,0,0,0,0,0,0,0,0,0,0,0,0,0,0,0,0,0,0,0,0,0,0,0,0,0,0,0,0,0,0,0,0,0,0,0,0,0,0,0,0,0,0,0,0,0,0,0,0,0,0,0,0,0,0,0,0,0,0,0,0,0,0,0,0,0,0,0,0,0,0,0,0,0,0,0,0,0,0,0,0,0,0,0,0,0,0,0,0,0,0,0,0,0,0,0,0,0,0,0,0,0,0,0,0,0,0,0,0,0,0,0,0,0,0,0,0,0,0,0,0,0,0,0,4,5,
5,15,2,2,2,2,2,2,2,2,2,2,2,2,2,2,2,2,2,2,2,2,2,2,2,2,2,2,2,2,2,2,2,2,2,2,2,2,2,2,2,2,2,2,2,2,2,2,2,2,2,2,2,2,2,2,2,2,2,2,2,2,2,2,2,2,2,2,2,2,2,2,2,2,2,2,2,2,2,2,2,2,2,2,2,2,2,2,2,2,2,2,2,2,2,2,2,2,2,2,2,2,2,2,2,2,2,2,2,2,2,2,2,2,2,2,2,2,2,2,2,2,2,2,2,2,2,2,2,2,2,2,2,2,16,5,
5,5,5,5,5,5,5,5,5,5,5,5,5,5,5,5,5,5,5,5,5,5,5,5,5,5,5,5,5,5,5,5,5,5,5,5,5,5,5,5,5,5,5,5,5,5,5,5,5,5,5,5,5,5,5,5,5,5,5,5,5,5,5,5,5,5,5,5,5,5,5,5,5,5,5,5,5,5,5,5,5,5,5,5,5,5,5,5,5,5,5,5,5,5,5,5,5,5,5,5,5,5,5,5,5,5,5,5,5,5,5,5,5,5,5,5,5,5,5,5,5,5,5,5,5,5,5,5,5,5,5,5,5,5,5,5,

